#######
# . $ #
#*@* $ #
# .    #
#      #
#######
