###########
#         #
#  $ #  . #        
#    #    #
#         #
#    #    #
#    @    #
###########