#######
#  *   #
#.$@$$ #
#  *   #
#      #
#######
