########
# . $  #
#  .   #
#  # . #
#  $ $ #
#  @   #
########
